---#--###--#--
-#---#----##-#
####-#-#-#-##-
---#---#-#----
-#-####---##--
-#------#-----
-#############
-------------@